1111111111111111111111111111111111111
10000000000000000000000000000000000C1
100F000000000111111101111111111111111
1000F0000011111111C001111000111111111
100000001111111C000001000C00111111111
1000011111111C000000000000001111111C1
1001111111C0000000P0000001111111100E1
10111111C0000000000000011111110000001
101111C000000000000C011111110000F0001
1011111111111111111101111111000001111
1011111111111111111101111111000111111
100000CCC0000111111101111111011111111
100C00CFC0000111111100000000000000001
100000CCC00C011111110000000C000000001
1111111111111111111111111111111111111
