1111111111111111111111111111111111
1E00F0000000000C0000FC0001000000F1
1010010100100000101001000100010101
1010010010101010001001000100010101
1010010010101010001001000100010101
1010010010101010001001000100010101
1010010010101010001001000100010111
10100100101010100010010001000101C1
1P0000000C00C000000000000001000111
1111111111111111111111111111111111