1111111111111111111111111111111111
100000000000000C00000C00C000000001
1C100101001000001010010CCC00010101
10100100101010100010010CPC00010111
100000000C00C0000000000CCC010000E1
1111111111111111111111111111111111
