1111111111111111111111111111111111
100E00000000000C00000F00C000000001
1C10010100100000101001010100010101
111001001010101000100101P100101000
100000000C00C000000000011101F00001
1111111111111111111111111111111111
