1111111111111111111111111111111111
100000000000000C00000F00C000000001
1C10010100100000101001010100010101
101001001010101000100101P100010111
100000000C00C000000000011101F000E1
1111111111111111111111111111111111
